------------------------------------------------------------------------------------------------------------------------------------------------------------------------------------------------------
------------------------------------------------------------------------------------------------------------------------------------------------------------------------------------------------------
------------------------------------------------------------------------------------------------------------------------------------------------------------------------------------------------------
------------------------------------------------------------------------------------------------------------------------------------------------------------------------------------------------------
------------------------------------------------------------------------------------------------------------------------------------------------------------------------------------------------------
------------------------------------------------------------------------------------------------------------------------------------------------------------------------------------------------------
-------------------------------------------------------------------------------------SUS------------------------------------------------------------------------------------------------##------------
----------------------------------------------------------------------------------------------------------------------------------------------------------------------------------------##------------
-------------------------------------------------------------------------------------------------------------------------------------------------------TT-------------------------------##------------
-------------------------------------------------------------------------------------------------------------------------------------------------------TT----------------------------#--##------------
------------------------------------------------------------------------------------#####-----------------------------------------------------#LSS-----##---------------------------##--##------------
---------------------------------------TT-----TT------------------------------------#--------------------------#------------------------------#------------------------------------###--##------------
---------------------------------------TT-----TT------------------------------------#---------------------*----#------------------------------#-----------*---TT-----*------------####------------F---
-M-------------------------------------TT-----TT------------------------------------#---------------------*----#------------------------------#-----------*---TT-----*-----------#####------------#---
XXXXXXXXXXXXXXXXXXXXXXXXXXXXXXXXXXXXXXXXXXXX--XXXXXXXXXXXXXXXXXXXXXXXXXXXXXXXXXXXXXXXXX----XXXXXXXXXXXXXXXXXX--XXXXXXXXXXXXXXXXXXXXXXXXXXXXXXXXXXXX---XXXXXXXXXXXXXXXXXXXXXXXXXXXXXXXXXXXXXXXXXXXXXXXX
XXXXXXXXXXXXXXXXXXXXXXXXXXXXXXXXXXXXXXXXXXXX--XXXXXXXXXXXXXXXXXXXXXXXXXXXXXXXXXXXXXXXXX----XXXXXXXXXXXXXXXXXX--XXXXXXXXXXXXXXXXXXXXXXXXXXXXXXXXXXXX---XXXXXXXXXXXXXXXXXXXXXXXXXXXXXXXXXXXXXXXXXXXXXXXX