-----------------------------------------------------------------------------------------------------------------------------------------------------------------------------------------------------
-----------------------------------------------------------------------------------------------------------------------------------------------------------------------------------------------------
-----------------------------------------------------------------------------------------------------------------------------------------------------------------------------------------------------
-----------------------------------------------------------------------------------------------------------------------------------------------------------------------------------------------------
---------------------------------------------------------------------------------------------------------------------------------------------------------------------------------------XX------------
---------------------------------------------------------------------------------------------------------------------------------------------------------------------------------------XX------------
---------------------LSSS---------------------QQQQQ-----------USSS--------SSCSS------SSSS-----------------------------USSS-----------------------------------SSSSS---?-------------C---XX------------
---------------------------------------------------------------------------------------------------------------------------------------------------------------------------------------XX------------
---------------------------------------------------------------------------------------------------------------------------------------------------------------------------------------XX------------
-----------------#---------------------------------------------------------------------------------------------------------TT----------------------------------------------------------XX------------
--------SUS-----##---2-----#-----------TT-----?QQQQ----------S-----TT---QQQQ--QQQ---------------TT-----------------TT------TT-----------------------------C--------Q--------------SS---XX------------
---------------###---------#-----------TT--------------------------TT---------------------------TT-----------------TT--tt--TT----------------------#---------------------TT------------XX------------
--------------####---------##----------TT--------------------------TT---------------------------TT----------TT-----TT--tt--TT----------------------#---------------------TT------------XX--------F---
--M----------#####---------##----------TT--------------------------TT---------------------------TT----------TT-----TT--tt--TT----------------------#---------------------TT------------XX--------X---
XXXXXXXXXXXXXXXXXXXXXXXXXXXXXXXXXXXXXXXXXXXXXXXXXXXXXXXXXXXXXXXXXXXXXXXXXXXXXXXXXXXXX----XXXXXXXXXX---XXXXXXXXXXXXXXXXXXXXXXXXXXXXXX---XXXXXXXXXX--XXXXXXXXXXXXXXXXXXXXXXXXXXXXXXXXXXXXXXXXXXXXXXXXXX
XXXXXXXXXXXXXXXXXXXXXXXXXXXXXXXXXXXXXXXXXXXXXXXXXXXXXXXXXXXXXXXXXXXXXXXXXXXXXXXXXXXXX----XXXXXXXXXX---XXXXXXXXXXXXXXXXXXXXXXXXXXXXXX---XXXXXXXXXX--XXXXXXXXXXXXXXXXXXXXXXXXXXXXXXXXXXXXXXXXXXXXXXXXXX