--------------------------------------------------------------------------------------------------------------------------------------------------------------------------------
--------------------------------------------------------------------------------------------------------------------------------------------------------------------------------
--------------------------------------------------------------------------------------------------------------------------------------------------------------------------------
------------------------------------------------------------------------------------------------------------------------------------------------U-------------------------------
--------------------------------------------------------------------------------------------------------------------------------------------------------------------------------
--------------------------------------------------------------------------------------------------------------------------------------------------------------------------------
--------------------USS-----------------------------------------------------SSSSSS----1----------------------------------------SSSSS------------------------------##------------
--------------------------------------------------------------------------------------------------------------------------------------------------SS-------------###------------
---------------------------------------------------------B---------------------------------------------------------------------------------------------#--------####------------
---------------------------------------------------------b------------------------------------------------------------------------------------SS------##-------#####------------
--------------------------------QQQQ-------------------SS#CS---------------SSSSSSS---------------------------------------------SSSSS-----------------###------######------------
---------------------B-----------------B---------B-------------------TT---------------TT--------------TT------------------------------#----B--------####-----#######------------
------------B--------b-------B---------b---------b-----------B-------TT---------------TT---------B----TT----TT-----B-----TT-----------#----b-------#####----########--------F---
-M----------b--------B-------b---------b---------B-----------b-------TT---------------TT---------b----TT----TT-----b-----TT-----------#----B------######---#########--------#---
XXXXXXXXXXXXXXXXXXXXXXXXXXXXXXXXXXXXXXXXXXXXXXXXXXXXXXXXXXXXXXXXXX--XXXXXXXXXXXXXXXXXXXXXXXXXXXXXXXXXXXXXXXXXXXXXXXXXXXXXXXXXXXXXXXXXXXXXXXXXXXXX-XXXXXXXXXXXXXXXXXXXXXXXXXXXXXX
XXXXXXXXXXXXXXXXXXXXXXXXXXXXXXXXXXXXXXXXXXXXXXXXXXXXXXXXXXXXXXXXXX--XXXXXXXXXXXXXXXXXXXXXXXXXXXXXXXXXXXXXXXXXXXXXXXXXXXXXXXXXXXXXXXXXXXXXXXXXXXXX-XXXXXXXXXXXXXXXXXXXXXXXXXXXXXX