----------------------------------------------------------------------------------------------------------------------------------------------------------------------------------------------------
----------------------------------------------------------------------------------------------------------------------------------------------------------------------------------------------------
----------------------------------------------------------------------------------------------------------------------------------------------------------------------------------------------------
----------------------------------------------------------------------------------------------------------------------------------------------------------------------------------------------------
----------------------------------------------------------------------------------------------------------------------------------------------------------------------------------------------------
----------------------------------------------------------------------------------------------------------------------------------------------------------------------------------------------------
---------------------------------------------------------------------------1-------USS------------------SSQSSS?SSS--------SSC------------------SQS--SQS--------------------------------##-----------
--------------------------------------------------------------------------------------------------------------------------------------------------------------------------------------###-----------
--------------------------------------------------------------------------------------------------------------------------------------#---------------------------------#------------####-----------
------------Q--?----------------------------------------------------------------------------------------------------------SSS--------##---------------------------------#-----------#####-----------
---------Q---------SSS---------TT---------------------S--------------##########---#-------------TT------SSSSSSSSSSS-----------------###--------SQS--S?S--------SCSSS----#----------######-----------
-------------------------TT----TT-----------------TT----------------##--------#---#-------------TT---------------------------------####--------------------------------##---------#######-----------
-------------------------TT----TT-----------------TT--------TT-----###--------#---##------------TT--------------------------------#####--------------------------------##--------########--------F--
-M-----------------------TT----TT-----------------TT--------TT----####--------#---##------------TT-------------------------------######--------------------------------##-------#########--------#--
XXXXXXXXXXXXXXXXXXXXXXXXXXXXXXXXXXXXXX---XXXXXXXXXXXXXXXXXXXXXXXXXXXXX--------X---XXXXXXXXXXXXXXXXXXXXXXXXXXXXXXXXXXXXXXX----XXXXXXXXXX--XXXXXXXXXXXXXXXXXXXXXXXXXXXXXXXX---XXXXXXXXXXXXXXXXXXXXXXXX
XXXXXXXXXXXXXXXXXXXXXXXXXXXXXXXXXXXXXX---XXXXXXXXXXXXXXXXXXXXXXXXXXXXX--------X---XXXXXXXXXXXXXXXXXXXXXXXXXXXXXXXXXXXXXXX----XXXXXXXXXX--XXXXXXXXXXXXXXXXXXXXXXXXXXXXXXXX---XXXXXXXXXXXXXXXXXXXXXXXX