----------------------------------------------------------------------------------------------------------------------------------------------------------------------------------------
----------------------------------------------------------------------------------------------------------------------------------------------------------------------------------------
----------------------------------------------------------------------------------------------------------------------------------------------------------------------------------------
----------------------------------------------------------------------------------------------------------------------------------------------------------------------------------------
----------------------------------------------------------------------------------------------------------------------------------------------------------------------------------------
----------------------------------------------------------------------------------------------------------------------------------------------------------------------------------------
-----------------------------US---------------------------------------------------------------------------2--------------------------------------------------------------###------------
----------------------------------------------------------------------------------#SSS-----------------------------------------------------------------------------------###------------
---------------------------------------------------------------------oo----------##----------------------------------------------------------#SS--o----------------------###------------
--------------------------------------------------------------------------------###1--------------ooo------------------XSS-?Q---------------##------------------------#--###------------
---------QQ-----------------####--SSC------------------ooo-------##-------------###-----------------------2-----------XX-------------------###--SC-------------------##--###------------
-------------------------#####----------------------------------###-----------#-###--SSS-------TT--------------------XXX------------------####----------------------###--###------------
----------------------######-----------------------------------####----------##-###------------TT-------------------XXXX-----------------#####---SSS---------------####--###--------F---
-------------------#######------------------------------------#####-------------###------------TT------------------XXXXX---SSSSS--------######--------------------#####--###--------#---
XXXXXXXXXXXXX--XXXXXXXXX------XX--XXXXXXXXXXXXXXXX--XXXXXXXXXXXXXXX---XXXXXXXXXXXXXXXX---XXXXXXXXXXXXXXXXXXXXXXXXXXXXXXX-------XX-XXXXXXXXXXXX------XXXXXXXXX---XXXXXXX--XXXXXXXXXXXXXXX
XXXXXXXXXXXXX--XXXXXXXXX------XX--XXXXXXXXXXXXXXXX--XXXXXXXXXXXXXXX---XXXXXXXXXXXXXXXX---XXXXXXXXXXXXXXXXXXXXXXXXXXXXXXX-------XX-XXXXXXXXXXXX------XXXXXXXXX---XXXXXXX--XXXXXXXXXXXXXXX