--------------------------------------------------------------------------------------------------------------------------------------------------------------
--------------------------------------------------------------------------------------------------------------------------------------------------------------
--------------------------------------------------------------------------------------------------------------------------------------------------------------
S-----SSSSSSSSSSSSSSSSSSSSSSSSSSSSSSSSSSSSSSSSSSSSSSSSSSSSSSSSSSSSSSSSSSSSSSSSSSSSSSSSSSSLSSSSSSSSSSSSSSSSSSSSSSSSSSSSSSSSSSSSSSSSSSSSSSSS--------------------
S-----------------------------------------------------SS--SSSSSS--SSSS------SSSS------------------------------------------------------------------------------
S-----------------------------------------------------SS--SSSSSS--SSSS------SSSS------------------------------------------------------------------------------
S----------------------------------------oooo-------SS--------SS---S----SS----------oooooo--------------------------------------------------SSS---------------
S---------------------------------------------------SS--------SS---S----SS------------------------------------------------------------------------------------
S--------------------------------------S-SSSS-U-----SS--------SS---S----SS----------SSSSSS--------------------------------------------------------------------
S----------------------------C---------SoS--SoS-----SS----ooooSS---SoU--SC----------SSSSSS-------------------------------------------------------SSSSSSU------
S---------@QQQQ--------#-#-------------SSS--SSS-----SSSS--SSSSSS---SSS--SS--SSSS-----------------------------TT-------------------------##--------------------
S--------------------#-#-#-#---#----------------------SS-----------------------------------------------TT----TT-----------SS-----------###--------------------
S------------------#-#-#-#-#---#-#--------------------SS-----------------------------------------------TT----TT----TT-----SS----------####--SSS---------------
S--M-------------#-#-#-#-#-#---#-#---------------------------------------------------------------------TT----TT----TT-----SS---------#####------------------F-
XXXXXXXXXXXXXXXXXXXXXXXXXXXXXXXXXXXXXXXXXXXXXXXXXXXXXXXXXXXXXXXXXXXXXXXXXXXXXXXX---XXXXXXXXXXXXXXXXXXXXXXXXXXXXXXXXXXXXX--XX--XXXXXXXXXXXX-------XXXXXXXX--XXX
XXXXXXXXXXXXXXXXXXXXXXXXXXXXXXXXXXXXXXXXXXXXXXXXXXXXXXXXXXXXXXXXXXXXXXXXXXXXXXXX---XXXXXXXXXXXXXXXXXXXXXXXXXXXXXXXXXXXXX--XX--XXXXXXXXXXXX-------XXXXXXXX--XXX