------------------------------------------------------------------------------------------------------------------------------------------------------
------------------------------------------------------------------------------------------------------------------------------------------------------
------------------------------------------------------------------------------------------------------------------------------------------------------
--------------------------------oo--------------------------------------------------------------------------------------------------------------------
------------------------------------------------------------------------------------------------------------------------------------------------------
----------------------ooo----------%%%%%%%-------------oooo-----------------------------oo--oo--------------------------------------------------------
---------------------%%%%%----------|||||--------------%%%%---------------------oo---------------------------------oo--------------------##-----------
----------------------|||-----------|||||----oo---SSSS--||-------------%%%%%%------------------------------------------------------------##-----------
----------------------|||-----------|||||---------------||--------------||||-----------------------%%%%%%%%----------------------------####-----------
----------------------|||-----%%%%%-|||||---------------||--------------||||-----SSS----------------||||||---------------------SSS-----####-----------
-------------------%%%%%%%%----|||--|||||---------------||-------%%%----||||-------------SSS--------||||||-----%%%%--%%%%------------######-----------
--------------------||||||-----|||--|||||-------------U-||--------|-----||||------------------------||||||------||----||-------------######-----------
--------------------||||||--o--|||--|||||---------------||--------|-----||||-----------------%%%%---||||||------||----||-------------######--------F--
-------------%%%%---||||||-%%%-|||--|||||---------------||--------|-----||||------------------||----||||||--ooo-||----||-------------######--------#--
XXXXXXXXXXX---||----||||||--|--|||--|||||----%%%%-----%%%%%-%%%%%-|-----||||------------------||----||||||--%%%-||----||----XXXXXXXXXXXXXXXXXXXXXXXXXX
XXXXXXXXXXX---||----||||||--|--|||--|||||-----||-------|||---|||--|-----||||------------------||----||||||---|--||----||----XXXXXXXXXXXXXXXXXXXXXXXXXX